00000000000000000000000000000000000000000000000001
00000000000000000000000000000000000000000000011101
00000000000000000000000000000000000000000001010001
00000000000000000000000000000000000000011000010111
00000088000000000070000000000000AA0000000015510001
00000066000AA0000660000100100000660000111111111101
0000000000A00A000000001A00A10000000001155555555101
3000000C000000000C00011A00A11000C00011400000000001
11111111110000111111111100111111111111111111111101
11111111111551111111111155111111111111111111111151