00000000000000000000000000000000000000000000000001
00000000000000000000000000000000000000000000000001
00000000000000000000000000000000000000000000000001
00000000000000000000000000000000000000000000000001
00000000000000000000000000000000000000000000000001
00000000000000000000000000000000000000000000000001
00000000000000000000000000000000000000000000000001
3000000C000000000C00000000000000C00000000000000041
11111111111111111111111111111111111111111111111111
11111111111111111111111111111111111111111111111111